11111111111111111111111111111111111111111111111111111111111
1P00000C000000C000000C0000000000000000000000000000011001111
1000000C000000C000000C0000000000000011111111100000110001111
1000000C000000C000000C1111111111111111111111111111111111111
1000000C000000C000000C1111111111111111111111111111111111111
1000000C000000C000000C1111111111111111111111111111111111111
1000000C000000C000000C1111111111111111111111111111111111111
1000000C000000C000000C1111111111111111111111111111111111111
1000000C000000C000000C1111111111111111111111111111111111111
1000000C000000C000000C1111111111111111111111111111111111111
1000000C000000C000000C1111111111111111111111111111111111111
1000000C000000C000000C1111111111111111111111111111111111111
1000000C000000C000000C1111111111111111111111111111111111111
1000000C000000C000000C000000000000000000000000000000E111111
11111111111111111111111111111111111111111111111111111111111