11111111111111111111111111111111111111111111111111111
1P00000C000000C000000C0000000000000000000000000000001
1000000C000000C000000C0000000000000000000000000000001
1000000C000000C000000C0000000000000000000000000000001
1000000C000000C000000C1111111111111111111111111111111
1000000C000000C000000C00000000000000000000000000000E1
11111111111111111111111111111111111111111111111111111