111111111111111111111111111111111111111111
1P1C11111111111111111111111111111111111111
1E1111111111111111111111111111111111111111
111111101111111111111111111111111111111111
111111111111111111111111111111111111111111