11111111111111111111111111111111111111111111111111111
1000000C000000C000000C0000000000000000000000000000001
1000000C000000C000000C0000000000000000000000000000001
1000000C000000C000000C0000000000000000000000000000001
1000000C000000C000000C1111111111111111111111111111111
1000000C000000C000000C0000000000000000000000000000001
1000000C000000C000000C0000000000000000000000000000001
111111111111111111CCCC0000000C000000000000000000000E1
1000000C000000C000000C0111111111111111111111111111111
1000000C000000C000000C0000000000000000000000000000001
1000000C000000C000000C0000000000000000000000000000001
1000C00C00000000C000000C0000000C000000000000000000001
1P111111111111111111111111111111111111111111111111111
11111111111111111111111111111111111111111111111111111