1111111111111111
1P00000000000001
1011111111111101
1000000000000001
1001111111111001
1001000000001001
1011111111111101
1000000000000001
1011111111111001
1001000000001001
1C11111111111101
1CCCCCCCCCC00001
1000000000CCCCE1
1111111111111111