111111111111
1C0000000PE1
111111111111

3840x2160

clos x rows