11111111111111111111111111111111111111111111111111111111111
11111111111111111111111111111111111111111111111111111111111
1P000000000000000000000000000000000000000000000000000000001
1C000000000000000000000000000000000000000000000000000000001
1C000000000000000000000000000000000000000000000000000000001
1C000000000000000000000000000000000000000000000000000000001
10000000000000000000000000001C00000000000000000000000000001
1C000000000000000000000000000000000000000000000000000000001
1C000000000000000000000000000000000000000000000000000000001
1C000000000000000000000000000000000000000000000000000000001
1C000000000000000000000000000000000000000000000000000000001
1C000000000000000000000000000000000000000000000000000000001
1C000000000000000000000000000000000000000000000000000000001
1C000000000000000000000000000000000000000000000000000000001
1C000000000000000000000000000000000000000000000000000000001
1C000000000000000000000000000000000000000000000000000000001
1C000000000000000000000000000000000000000000000000000000001
1C000000000000000000000000000000000000000000000000000000001
1C000000000000000000000000000000000000000000000000000000001
1C000000000000000000000000000000000000000000000000000000001
1C000000000000000000000000000000000000000000000000000000001
1C000000000000000000000000000000000000000000000000000000001
1C000000000000000000000000000000000000000000000000000000001
1C000000000000000000000000000000000000000000000000000000001
1C000000000000000000000000000000000000000000000000000000001
1C000000000000000000000000000000000000000000000000000000001
1C000000000000000000000000000000000000000000000000000000001
100000000000000000000000000C0000000000000000000000000000001
1C000000000000000000000000000000000000000000000000000000001
1C0000000000000000000000000000000000000000000000000000001E1
11111111111111111111111111111111111111111111111111111111111
11111111111111111111111111111111111111111111111111111111111
11111111111111111111111111111111111111111111111111111111111