111111
1PC001
10C001
10C0E1
111111