1111111111111111111111111111111111
1E00000000000000000000000000000001
10100101001000001110P1000000010101
1C10010010101000001001000000010101
1P00000000000000000000000000000001
1111111111111111111111111111111111