1111111111111111111111111111111111
1E0000000100000C00000C000010000001
1010010100100000101001000000010101
1010010010101010001001000000010101
10000000C00C0010000000P00000000C11
1111111111111111111111111111111111