111111
1PC0E1
10C001
10C001
111111