
111111
10C0E1
10C0P1
10Cp01
111111